+-+-+-+-+-+
|.|. . . .|
+ + + + + +
|.|.|.|.|.|
+ + + + +-+
|. .|.|. .]
+ +-+ +-+ +
|.|. . .|.|
+-+-+-+-+-+


+-+
|.|
+-+


+-+-+
|. .|
+ + +
|. .|
+-+-+