+-+-+-+-+-+-+-+-+
|. . .|.|. . . .|
+ +-+-+ +-+-+-+ +
|.|. . .|. .|. .|
+ + +-+-+ + + +-+
|.|.|.|. .|.|. .]
+ + + + + + +-+ +
|. .|. .|.|. . .|
+ +-+ +-+ +-+ + +
|. .|. .|.|. .|.|
+-+ +-+ + +-+-+-+
|. .|. .|. . . .|
+ +-+-+-+-+-+ + +
|. . .|. . .|.|.|
+-+-+ + +-+ +-+ +
|. . . .|. . . .|
+-+-+-+-+-+-+-+-+

+-+-+-+-+-+
|.|. . . .|
+ + + + + +
|.|.|.|.|.|
+ + + + +-+
|. .|.|. .]
+ +-+ +-+ +
|.|. . .|.|
+-+-+-+-+-+


+-+
|.|
+-+


+-+-+
|. .|
+ + +
|. .|
+-+-+